
NO 1.xpm
SO 2.xpm
WE 4.xpm
C 225,200,10
EA 3.xpm
F 200,30,0


111111111111111
101010001100011
101011101011101
1000W0001011101
111010111011101
111010001100011
111111111111111