111111111111111
101010001100011
101011101011101
1000N0001011101
111010111011101
111010001100011
111111111111111