111111111
11NCCCCC1
1PECC0001
111111111