NO ./sprites/north.xpm
EA ./sprites/east.xpm
SO ./sprites/south.xpm
WE ./sprites/west.xpm

C 225,30,0				
F 1,1,1

1111111111111111111111111
1000000000000000000000001
1011111111111111111111101
1000100000000000000010011
1010111111111110111111101
1000100000100000000010011
1010111110101011111011101
1000100000000000001010011
1010111111111010101111101
1000100000100000001010011
1010111110101010101011101
1000100000000000001010011
1010111111111010101111101
1000100000100000001010011
1010111110101010101011101
1000100000000000001010011
1010111111111010101111101
1000100000100000001010011
1010111110101010101011101
1000100000000000001010011
1010111111111010101111101
1000100000100000001010011
1010111110101010101011101
1000100000000000001010011
1010111111111010101111101
1N00000000000000101010011
1111111111111111111111111
